111111111111111        11111111111111
100100010000010        10000000000011
1010000100111101111111110000000000011
1000N00000001100000000000000000000001
1000000000000001110000000000000000001
1000000010000011110000000000000000001
1000000001000011110000000000000000001
1000000000100011110000000000000000001
1000000000010011110000000000000000001
1000000000001111110000000000000000001
1000000000000111110000000000000000001
1000010110101000000000000000000000001
1000010110101000000000000000000000001
1000000000001000000000000000000000001
1111111111111111111111111111111111111
