111111111111111        1111111
100100010000011        1000001
101000010011111111111111000001
1000N0000000110000000000000001
100000000000000111000000000001
100000001000001111000000000001
100000000100001111000000000001
100000000010001111000000000001
100000000001001111000000000001
100000000000111111000000000001
100000000000011111000000000001
100001011010100000000000000001
100001011010100000000000000001
100000000000100000000000000001
111111111111111111111111111111
