NO ./img/redbrick.xpm
WE ./img/greystone.xpm
SO ./img/bluestone.xpm
EA ./img/colorstone.xpm

F 111,111,111
C 123,160,200


1111111111111111111111111111111111111111111
1111110011111111111111111111000S00001111111
1111100001111111111111111110000000001111111
1111100001111111111111111100000000011111111
1110000001111111111111111000000000011111111
1110000001111111111111111000000000001111111
1111000001111111111111111100111110001111111
1111100000111001100111111111111110001111111
1111111110000000000001111111111000001111111
1111111111000000000001111111100000000111111
1111111111110000000000000111000000000111111
1111111111111111111000000000000000001111111
1111111111111111111100000000000000111111111
1111111111111111111100000000000000111111111
1111111111111111111110000000000000111111111
1111111111111111111110000000000000011111111
1111111111111111111110000000000000011111111
1111111111111000000000000000000000111111111
1111111111110000000000000000000111111111111
1111111111110001010000000000011111111111111
1111111111111001110111111110000111000111111
1111111111111111111111111111000000000001111
1111111111111111111111111111110000011111111
1111111111111111111111111111111111111111111
1111111111111111111111111111111111111111111
1111111111111111111111111111111111111111111
1111111111111111111111111111111111111111111
1111111111111111111111111111111111111111111

