F 92,117,84

NO ./img/bluestone.xpm
SO ./img/redbrick.xpm
WE ./img/greystone.xpm
EA ./img/colorstone.xpm

C 198, 252 , 255

111111111111111        1111111
100100010000011        1000001
101100010011111111111111000001
100100000000110000000000000001
100100000000000101000000001101
10010000100000110100000001  11
1000N0111111000010010000001101
1000001    1100011010000000001
100000111111100111000000000001
100000000000100111000000000001
100000000000010111000000000001
100001011010100000000000000001
100001011010100000000000000001
100000000000100000000000000001
111111111111111111111111111111
